[Modal]
50

[Random]
[Jumlah Peti]
2,3,3

[Skor]
45

[Waktu]
35

[Simpul]
10

[Jarak Simpul]
0,18,22,-99,-99,-99,2,7,12,16
18,0,2,7,12,17,22,-99,-99,-99
22,2,0,13,18,23,-99,-99,-99,2
-99,7,13,0,10,15,20,24,-99,-99
-99,12,18,10,0,-99,-99,3,8,12
-99,17,23,15,-99,0,3,7,12,17
2,22,-99,20,-99,3,0,-99,3,8
7,-99,-99,24,3,7,-99,0,12,17
12,-99,-99,-99,8,12,3,12,0,20
16,-99,2,-99,12,17,8,17,20,0

