[Modal]
500

[Random]
[Jumlah Peti]
15,20,10

[Skor]
450

[Waktu]
100

[Simpul]
50

[Jarak Simpul]
0,10,14,-99,4,9,14,-99,4,8,13,-99,3,8,1,5,10,15,-99,5,10,15,-99,4,9,14,-99,4,9,13,-99,3,8,13,-99,3,7,12,-99,2,7,12,-99,1,6,11,-99,1,6,10
10,0,14,-99,4,9,14,-99,3,8,13,-99,3,7,12,-99,10,15,-99,5,9,14,-99,4,9,14,-99,3,8,13,-99,3,8,12,-99,2,7,12,-99,2,6,11,-99,1,6,11,-99,-99,5,10
14,14,0,5,10,15,-99,4,9,14,-99,4,9,13,-99,3,8,13,-99,2,15,-99,5,10,15,-99,4,9,14,-99,4,9,14,-99,3,8,13,-99,3,8,12,-99,2,7,12,-99,1,6,11,-99
-99,-99,5,0,2,7,12,-99,1,6,11,-99,1,6,10,15,-99,5,10,15,-99,4,9,14,-99,4,-99,1,6,11,-99,1,6,11,15,-99,5,10,15,-99,4,9,14,-99,4,9,14,-99,3,8
4,4,10,2,0,5,10,15,-99,4,9,14,-99,4,9,14,-99,3,8,13,-99,3,8,12,-99,2,7,12,-99,1,6,11,-99,1,6,-99,3,8,13,-99,3,8,13,-99,2,7,12,-99,2,7
9,9,15,7,5,0,15,-99,4,9,14,-99,4,8,13,-99,3,8,13,-99,2,7,12,-99,2,7,12,-99,1,6,11,-99,1,6,10,15,-99,5,10,15,-99,4,9,14,-99,4,-99,1,6,11
14,14,-99,12,10,15,0,10,15,-99,5,10,14,-99,4,9,14,-99,4,8,13,-99,3,8,13,-99,2,7,12,-99,2,7,11,-99,1,6,11,-99,1,5,10,15,-99,5,10,15,-99,4,9,14
-99,-99,4,-99,15,-99,10,0,4,9,14,-99,4,8,13,-99,3,-99,1,5,10,15,-99,5,10,15,-99,4,9,14,-99,4,9,13,-99,3,8,13,-99,3,7,12,-99,2,7,12,-99,1,6,11
4,3,9,1,-99,4,15,4,0,12,-99,2,7,12,-99,1,6,11,-99,1,6,10,15,-99,5,10,15,-99,4,9,14,-99,4,9,14,6,11,-99,1,6,11,-99,-99,5,10,15,-99,5,9,14
8,8,14,6,4,9,-99,9,12,0,7,11,-99,1,6,11,-99,1,5,10,15,-99,5,10,15,-99,4,9,14,-99,4,9,13,-99,3,8,13,-99,2,7,12,-99,2,7,12,-99,1,6,11,-99
13,13,-99,11,9,14,5,14,-99,7,0,-99,4,9,14,-99,4,8,13,6,11,-99,1,5,10,15,-99,5,10,15,-99,4,9,14,-99,4,9,13,-99,3,8,13,-99,2,7,12,-99,2,7,12
-99,-99,4,-99,14,-99,10,-99,2,11,-99,0,6,11,-99,1,5,10,15,-99,5,10,15,-99,4,9,14,-99,4,9,13,-99,3,8,13,-99,3,7,12,-99,2,7,12,-99,1,14,-99,4,9,14
3,3,9,1,-99,4,14,4,7,-99,4,6,0,-99,4,9,14,-99,3,8,13,-99,3,8,13,-99,2,7,12,-99,2,6,11,-99,1,6,11,-99,-99,5,10,15,-99,5,10,14,-99,4,9,14
8,7,13,6,4,8,-99,8,12,1,9,11,-99,0,10,15,-99,5,10,15,-99,4,9,14,-99,4,9,14,-99,3,8,13,-99,3,8,12,-99,2,7,12,-99,1,6,-99,4,9,14,-99,3,8
1,12,-99,10,9,13,4,13,-99,6,14,-99,4,10,0,8,1,6,11,15,-99,5,10,15,-99,5,9,14,-99,4,9,14,-99,3,8,13,-99,3,8,12,-99,2,7,12,-99,2,6,11,-99,1
5,-99,3,15,14,-99,9,-99,1,11,-99,1,9,15,8,0,-99,5,9,14,-99,4,9,14,-99,3,8,13,-99,3,8,13,-99,2,7,12,-99,2,7,11,-99,1,6,11,-99,-99,5,10,15,-99
10,10,8,-99,-99,3,14,3,6,-99,4,5,14,-99,1,-99,0,10,15,-99,4,9,14,-99,4,9,13,-99,3,-99,1,6,11,15,-99,5,10,15,-99,5,9,14,-99,4,9,14,-99,3,8,13
15,15,13,5,3,8,-99,-99,11,1,8,10,-99,5,6,5,10,0,14,-99,4,9,13,-99,3,8,13,-99,3,7,12,-99,2,7,12,-99,1,6,11,-99,1,6,10,15,-99,5,10,15,-99,4
-99,-99,-99,10,8,13,4,1,-99,5,13,15,3,10,11,9,15,14,0,-99,1,6,11,-99,1,6,10,15,-99,5,10,15,-99,4,9,14,-99,4,9,14,-99,3,8,13,-99,3,7,12,-99,2
5,5,2,15,13,-99,8,5,1,10,6,-99,8,15,15,14,-99,-99,-99,0,5,10,15,-99,5,9,14,-99,4,9,14,-99,3,8,13,-99,11,-99,-99,5,10,15,-99,5,10,14,-99,4,9,14
10,9,15,-99,-99,2,13,10,6,15,11,5,13,-99,-99,-99,4,4,1,5,0,-99,5,10,3,8,12,-99,2,7,12,-99,1,6,11,-99,1,6,11,15,-99,5,10,15,-99,5,9,14,-99,4
15,14,-99,4,3,7,-99,15,10,-99,-99,10,-99,4,5,4,9,9,6,10,-99,0,9,14,-99,4,9,14,-99,3,8,13,-99,3,7,12,-99,2,7,12,-99,1,6,11,-99,1,6,11,15,-99
-99,-99,5,9,8,12,3,-99,15,5,1,15,3,9,10,9,14,13,11,15,5,9,0,-99,2,6,11,-99,1,6,11,15,-99,5,10,15,-99,5,9,14,-99,4,9,14,-99,3,8,13,-99,3
4,4,10,14,12,-99,8,5,-99,10,5,-99,8,14,15,14,-99,-99,-99,-99,10,14,-99,0,10,15,-99,5,10,15,-99,4,9,14,-99,4,8,13,-99,3,8,13,-99,2,7,12,-99,2,7,12
9,9,15,-99,-99,2,13,10,5,15,10,4,13,-99,-99,-99,4,3,1,5,3,-99,2,10,0,10,15,-99,5,10,14,-99,4,9,14,-99,3,8,13,-99,3,8,13,-99,2,7,12,-99,2,7
14,14,-99,4,2,7,-99,15,10,-99,15,9,-99,4,5,3,9,8,6,9,8,4,6,15,10,0,-99,1,6,11,-99,-99,5,10,15,-99,5,10,14,-99,4,9,14,-99,4,8,13,-99,3,8
-99,-99,4,-99,7,12,2,-99,15,4,-99,14,2,9,9,8,13,13,10,14,12,9,11,-99,15,-99,0,9,13,-99,3,8,13,-99,2,7,12,-99,2,7,12,-99,1,6,11,-99,1,6,10,15
4,3,9,1,12,-99,7,4,-99,9,5,-99,7,14,14,13,-99,-99,15,-99,-99,14,-99,5,-99,1,9,0,7,12,-99,2,6,11,-99,1,6,11,-99,-99,5,10,15,-99,5,10,14,-99,4,9
9,8,14,6,-99,1,12,9,4,14,10,4,12,-99,-99,-99,3,3,-99,4,2,-99,1,10,5,6,13,7,0,12,-99,2,6,11,-99,1,6,11,-99,-99,5,10,15,-99,5,9,14,-99,4,9
13,13,-99,11,1,6,-99,14,9,-99,15,9,-99,3,4,3,-99,7,5,9,7,3,6,15,10,11,-99,12,12,0,3,8,13,-99,2,7,12,-99,2,7,11,-99,1,6,11,-99,-99,5,10,15
-99,-99,4,-99,6,11,2,-99,14,4,-99,13,2,8,9,8,1,12,10,14,12,8,11,-99,14,-99,3,-99,-99,3,0,-99,5,10,15,-99,4,9,14,-99,4,9,13,-99,3,8,13,-99,3,7
3,3,9,1,11,-99,7,4,-99,9,4,-99,6,13,14,13,6,-99,15,-99,-99,13,15,4,-99,-99,8,2,2,8,-99,0,-99,-99,5,10,15,-99,5,10,14,7,12,-99,2,7,12,-99,1,6
8,8,14,6,-99,1,11,9,4,13,9,3,11,-99,-99,-99,11,2,-99,3,1,-99,-99,9,4,5,13,6,6,13,5,-99,0,5,10,15,-99,5,10,14,-99,4,9,14,-99,4,8,13,-99,3
13,12,-99,11,1,6,-99,13,9,-99,14,8,-99,3,3,2,15,7,4,8,6,3,5,14,9,10,-99,11,11,-99,10,-99,5,0,1,6,11,-99,1,5,10,15,-99,5,10,15,-99,4,9,14
-99,-99,3,15,6,10,1,-99,14,3,-99,13,1,8,8,7,-99,12,9,13,11,7,10,-99,14,15,2,-99,-99,2,15,5,10,1,0,15,8,13,-99,3,8,13,-99,2,7,12,-99,2,6,11
3,2,8,-99,-99,15,6,3,6,8,4,-99,6,12,13,12,5,-99,14,-99,-99,12,15,4,-99,-99,7,1,1,7,-99,10,15,6,15,0,4,9,14,-99,3,8,13,-99,3,7,12,-99,2,7
7,7,13,5,3,-99,11,8,11,13,9,3,11,-99,-99,-99,10,1,-99,11,1,-99,-99,8,3,5,12,6,6,12,4,15,-99,11,8,4,0,-99,3,8,13,-99,3,8,12,-99,2,7,12,-99
12,12,-99,10,8,5,-99,13,-99,-99,13,7,-99,2,3,2,15,6,4,-99,6,2,5,13,8,10,-99,11,11,-99,9,-99,5,-99,13,9,-99,0,11,-99,1,6,11,-99,-99,5,10,15,-99,5
-99,-99,3,15,13,10,1,-99,1,2,-99,12,-99,7,8,7,-99,11,9,-99,11,7,9,-99,13,14,2,-99,-99,2,14,5,10,1,-99,14,3,11,0,-99,3,8,13,-99,3,8,12,-99,2,7
2,2,8,-99,-99,15,5,3,6,7,3,-99,5,12,12,11,5,-99,14,5,15,12,14,3,-99,-99,7,-99,-99,7,-99,10,14,5,3,-99,8,-99,-99,0,4,9,13,-99,3,8,13,-99,3,7
7,6,12,4,3,-99,10,7,11,12,8,2,10,-99,-99,-99,9,1,-99,10,-99,-99,-99,8,3,4,12,5,5,11,4,14,-99,10,8,3,13,1,3,4,0,3,8,13,-99,3,8,12,-99,2
12,11,-99,9,8,4,15,12,-99,-99,13,7,15,1,2,1,14,6,3,15,5,1,4,13,8,9,-99,10,10,-99,9,7,4,15,13,8,-99,6,8,9,3,0,1,6,11,-99,1,5,10,15
-99,-99,2,14,13,9,-99,-99,-99,2,-99,12,-99,6,7,6,-99,10,8,-99,10,6,9,-99,13,14,1,15,15,1,13,12,9,-99,-99,13,3,11,13,13,8,1,0,5,10,15,-99,5,-99,2
1,1,7,-99,-99,14,5,2,5,7,2,-99,5,-99,12,11,4,15,13,5,15,11,14,2,-99,-99,6,-99,-99,6,-99,-99,14,5,2,-99,8,-99,-99,-99,13,6,5,0,3,8,13,-99,3,8
6,6,12,4,2,-99,10,7,10,12,7,1,10,4,-99,-99,9,-99,-99,10,-99,-99,-99,7,2,4,11,5,5,11,3,2,-99,10,7,3,12,-99,3,3,-99,11,10,3,0,-99,5,10,14,-99
11,11,-99,9,7,4,15,12,15,-99,12,14,14,9,2,-99,14,5,3,14,5,1,3,12,7,8,-99,10,9,-99,8,7,4,15,12,7,-99,5,8,8,3,-99,15,8,-99,0,3,7,12,-99
-99,-99,1,14,12,-99,-99,-99,-99,1,-99,-99,-99,14,6,5,-99,10,7,-99,9,6,8,-99,12,13,1,14,14,-99,13,12,8,-99,-99,12,2,10,12,13,8,1,-99,13,5,3,0,12,-99,1
1,-99,6,-99,-99,1,4,1,5,6,2,4,4,-99,11,10,3,15,12,4,14,11,13,2,-99,-99,6,-99,-99,5,-99,-99,13,4,2,-99,7,15,-99,-99,12,5,5,-99,10,7,12,0,15,-99
6,5,11,3,2,6,9,6,9,11,7,9,9,3,-99,15,8,-99,-99,9,-99,15,-99,7,2,3,10,4,4,10,3,1,-99,9,6,2,12,-99,2,3,-99,10,-99,3,14,12,-99,15,0,-99
10,10,-99,8,7,11,14,11,14,-99,12,14,14,8,1,-99,13,4,2,14,4,-99,3,12,7,8,15,9,9,15,7,6,3,14,11,7,-99,5,7,7,2,15,2,8,-99,-99,1,-99,-99,0
