[Modal]
100

[Random]
[Jumlah Peti]
3,7,8

[Skor]
70

[Waktu]
60

[Simpul]
20

[Jarak Simpul]
0,-99,4,9,14,-99,4,9,13,6,11,-99,1,6,11,15,-99,5,10,15
-99,0,4,9,14,-99,3,8,13,-99,11,-99,1,5,10,15,-99,5,10,15
4,4,0,15,-99,5,9,14,-99,4,9,14,-99,3,-99,1,6,11,-99,-99
9,9,15,0,12,-99,2,6,11,-99,1,6,11,15,-99,5,10,15,-99,5
14,14,-99,12,0,15,-99,5,10,14,-99,4,9,14,-99,4,8,13,-99,3
-99,-99,5,-99,15,0,4,9,14,-99,4,9,14,-99,3,8,13,-99,3,8
4,3,9,2,-99,4,0,-99,5,10,15,-99,4,9,14,-99,4,9,14,-99
9,8,14,6,5,9,-99,0,14,-99,4,-99,1,6,11,-99,1,6,11,15
13,13,-99,11,10,14,5,14,0,2,7,12,-99,2,6,11,-99,1,6,11
6,-99,4,-99,14,-99,10,-99,2,0,-99,1,6,11,-99,1,6,11,15,-99
11,11,9,1,-99,4,15,4,7,-99,0,9,14,-99,12,-99,1,6,11,-99
-99,-99,14,6,4,9,-99,-99,12,1,9,0,-99,1,6,11,15,-99,5,10
1,1,-99,11,9,14,4,1,-99,6,14,-99,0,9,14,-99,4,9,13,-99
6,5,3,15,14,-99,9,6,2,11,-99,1,9,0,-99,5,10,15,-99,5
11,10,-99,-99,-99,3,14,11,6,-99,12,6,14,-99,0,6,11,-99,1,5
15,15,1,5,4,8,-99,-99,11,1,-99,11,-99,5,6,0,10,15,-99,4
-99,-99,6,10,8,13,4,1,-99,6,1,15,4,10,11,10,0,-99,5,9
5,5,11,15,13,-99,9,6,1,11,6,-99,9,15,-99,15,-99,0,4,9
10,10,-99,-99,-99,3,14,11,6,15,11,5,13,-99,1,-99,5,4,0,6
15,15,-99,5,3,8,-99,15,11,-99,-99,10,-99,5,5,4,9,9,6,0
